BBBBBBBBBBBBBBBBBBBBBBBBBBBBBBBB
B                              B
B                   P    S    GB
B                P       S   PPB
B             P          S     B
B         P             T      B
B      P                       B
B  PP                   T      B
B      P            P P        B
B        P      TTT            B
B           P P                B
B  X    S                      B
BPPPPPPPPPPPPPPPPPPPPPPPPPPPPPPB
BBBBBBBBBBBBBBBBBBBBBBBBBBBBBBBB


