PPPPPPPPPPPPPPPPPPPPPPPPPPPPPPPP
P                              P
P                   P    S    GP
P                P       S   PPP
P             P          S     P
P         P             T      P
P      P                       P
P  PP                   T      P
P      P            P P        P
P        P      TTT            P
P           P P                P
P  X                           P
PPPPPPPPPPPPPPPPPPPPPPPPPPPPPPPP